1 1 2 2 1 1 1 1 1 1 1 1 1 1 1 1 1 1 1 1 1 1 1 1 1 
0 0 0 0 4 0 0 0 0 0 0 2 1 1 1 0 0 0 0 8 1 0 0 0 1
0 0 0 0 0 0 5 0 0 0 0 1 1 1 0 0 0 0 0 0 1 0 0 0 1
0 0 0 0 0 0 0 0 0 0 0 0 6 0 0 0 0 4 0 0 1 0 5 0 1
1 1 1 1 1 1 1 1 0 0 0 0 0 0 0 0 0 4 0 0 1 2 0 0 1
2 2 2 2 2 2 2 1 0 0 0 0 0 2 2 0 0 0 0 0 1 2 0 0 1 
2 2 2 2 2 2 2 1 9 7 0 0 0 2 1 0 0 0 0 0 1 2 0 7 1 
1 1 1 1 1 1 1 1 1 1 1 1 1 1 1 1 0 0 5 1 1 0 0 0 1 
1 0 0 0 9 0 0 1 0 0 0 0 6 0 2 1 0 0 0 1 1 0 0 0 1 
1 3 3 3 3 3 3 1 0 0 0 0 0 0 2 2 0 0 0 1 1 0 0 0 1 
1 0 0 0 0 0 0 7 0 0 0 0 0 0 0 0 0 0 0 1 1 0 0 0 1 
1 8 0 1 0 0 0 0 0 0 0 0 0 0 0 0 5 0 2 1 1 0 0 0 1 
1 0 0 0 0 0 0 0 0 4 4 4 4 0 0 0 0 2 2 1 1 0 0 6 1 
1 0 0 0 0 0 0 0 0 4 4 4 4 0 0 1 1 1 1 1 2 0 0 0 1 
1 8 0 1 0 0 0 0 0 0 0 0 0 0 0 1 0 0 0 2 2 0 0 0 1 
1 0 0 0 0 0 0 0 7 0 0 0 0 0 0 1 0 0 0 0 0 0 0 0 1 
1 0 2 0 0 0 2 2 2 2 2 2 2 2 2 1 0 5 0 0 0 0 7 0 1
1 0 3 0 0 0 2 1 1 1 1 1 1 1 1 1 0 0 0 0 0 0 0 0 1
2 2 2 2 2 0 2 2 0 0 0 0 0 0 0 0 0 0 0 0 0 0 0 2 1
2 2 2 2 2 0 0 0 0 0 0 0 0 0 0 0 0 0 0 0 0 0 0 2 1
2 2 3 2 2 0 0 7 0 0 0 0 0 0 0 0 5 0 0 0 0 0 0 2 1
3 3 2 0 2 0 0 0 4 4 4 4 0 0 2 2 0 0 0 2 2 2 2 2 1
2 2 2 2 2 0 0 0 4 4 4 4 0 0 2 1 1 1 1 2 0 0 0 0 1
2 2 2 2 2 0 0 0 0 0 0 0 0 0 2 1 1 1 1 2 0 9 0 6 1
2 2 2 2 2 1 1 1 1 1 1 1 1 1 1 1 1 1 1 1 1 1 1 1 1