1 1 1 1 1 1 1 1 1 1 1 1 1 1 1 1 1 1 1 1 1 1 1 1 1
1 2 2 2 6 0 0 0 0 0 0 0 0 0 0 2 1 1 1 2 14 13 9 0 1
1 2 0 0 0 0 0 0 4 4 4 4 0 0 2 2 1 1 1 2 0 0 8 0 1
1 2 0 0 0 0 0 0 4 4 4 4 0 0 2 2 0 0 0 2 2 2 2 2 1 
1 2 0 0 0 0 0 0 0 0 0 0 0 0 0 0 0 5 0 0 0 0 0 2 1 
1 2 0 0 0 0 0 0 7 0 0 0 0 0 0 0 0 0 0 0 0 0 0 2 1 
1 0 0 0 0 0 0 2 0 0 0 0 0 0 0 0 0 0 0 0 0 0 0 2 1 
1 0 0 8 0 0 0 2 1 1 1 1 1 1 1 1 0 0 5 0 0 0 7 0 1 
1 0 0 0 0 0 0 2 2 2 2 2 2 2 2 1 0 0 0 0 0 0 0 0 1 
1 0 0 0 0 0 0 0 0 0 0 0 0 0 0 1 0 0 0 0 0 0 0 0 1 
1 0 0 7 0 0 0 0 0 0 14 0 7 0 0 1 0 0 0 2 2 0 0 0 1
1 0 0 0 0 0 0 0 0 4 4 4 4 0 0 1 1 1 1 1 2 0 0 0 1 
1 0 0 8 0 0 8 0 0 4 4 4 4 0 0 0 0 2 2 1 1 0 0 12 1 
1 0 0 0 0 0 0 0 0 0 0 0 0 0 0 0 5 0 2 1 1 0 0 0 1 
1 0 0 0 0 0 0 0 0 0 0 0 0 0 0 0 0 0 0 1 1 0 0 0 1 
1 3 3 3 3 3 3 1 0 0 0 0 0 0 2 2 0 0 0 1 1 0 0 0 1 
1 0 0 15 9 0 0 1 0 0 0 0 10 0 2 1 0 0 0 1 1 0 0 0 1
1 1 1 1 1 1 1 1 1 1 1 1 1 1 1 1 0 5 0 1 1 0 0 0 1 
2 2 2 2 2 2 2 1 0 13 9 0 0 2 1 0 0 0 0 0 1 2 7 0 1 
2 2 2 2 2 2 2 1 0 0 7 0 0 2 2 0 0 0 0 0 1 2 0 0 1 
1 1 1 1 1 1 1 1 0 0 0 0 0 0 0 0 0 4 0 0 1 2 0 0 1 
0 0 0 0 0 0 16 3 0 0 0 0 10 0 0 0 0 4 0 0 1 0 5 0 1
0 0 0 0 8 0 0 3 0 0 0 1 1 1 2 0 0 0 8 8 1 0 0 0 1
0 0 0 0 0 0 0 3 0 0 0 2 1 1 1 0 0 0 8 15 1 0 0 0 1
1 1 1 1 1 1 1 1 1 1 1 1 1 1 1 1 1 1 1 1 1 1 17 0 1