1 1 1 1 1 1 1 1 1 1 1 1 1 1 1 1 1 1 1 1 1 1 0 0 1 
1 14 2 0 0 10 0 0 0 0 0 0 0 0 8 0 0 0 0 2 2 2 0 0 1 
1 2 2 0 0 0 0 0 0 0 0 0 0 0 8 0 0 0 0 0 2 2 0 0 1 
1 0 0 0 0 0 0 0 0 0 7 0 0 0 8 0 0 0 0 0 0 0 0 0 1 
1 0 0 0 0 0 0 0 0 0 0 0 0 0 8 0 0 0 0 0 0 5 0 0 1 
1 0 0 0 2 2 0 0 0 0 0 0 2 2 2 0 0 0 0 0 0 0 0 0 1 
1 8 8 8 2 1 1 1 1 1 1 1 1 1 1 0 0 0 0 0 0 0 0 0 1 
1 0 0 0 2 2 0 0 0 0 0 0 0 2 1 1 1 1 1 1 1 1 1 1 1 
1 0 0 0 0 0 0 0 7 0 0 0 0 2 2 0 0 0 0 0 0 4 4 4 1 
1 0 0 0 0 0 0 0 0 0 0 0 0 8 0 0 0 0 0 0 0 4 4 4 1 
1 0 0 0 0 0 0 0 0 0 0 0 0 8 5 0 0 0 0 0 0 0 0 0 1 
1 10 0 0 0 0 0 0 0 0 0 0 0 8 0 0 0 0 0 0 0 0 0 0 1 
1 0 0 0 0 0 0 0 0 0 0 0 0 2 2 0 0 0 0 0 0 0 0 0 1 
1 0 0 0 0 0 0 0 0 0 0 1 1 1 2 0 0 0 0 0 5 0 0 0 1 
1 0 0 0 0 0 6 0 0 0 0 1 1 1 1 1 0 0 0 0 0 0 0 0 1 
1 3 3 3 3 1 1 1 1 1 1 1 2 2 2 1 1 0 0 0 0 0 0 0 1 
1 2 8 8 2 1 2 2 2 2 2 2 2 0 2 2 1 1 0 0 0 0 0 0 1 
1 2 9 13 2 1 2 0 0 0 0 0 0 0 0 0 0 0 0 0 0 0 0 0 1 
1 2 2 2 2 1 2 0 0 0 7 0 0 0 0 0 0 0 0 0 15 0 0 0 1 
1 1 1 1 1 1 2 0 0 0 0 0 0 0 0 0 0 0 0 0 0 0 0 0 1 
1 0 0 0 0 8 0 0 0 0 0 0 0 0 0 0 0 0 0 0 0 0 0 0 1 
1 0 0 0 0 8 0 0 0 0 0 0 0 0 0 0 0 0 0 0 4 4 4 0 1 
1 0 0 0 0 8 0 0 0 0 0 0 0 0 0 0 7 0 0 0 4 4 4 0 1 
1 0 0 0 0 8 0 0 0 0 0 0 0 0 0 0 0 0 0 0 0 0 0 0 1 
1 1 1 1 1 1 1 1 1 1 1 1 1 1 1 1 1 1 1 1 1 1 1 1 1 
