1 1 1 1 1 1 1 1 1 1 1 1 1 1 1 1 1 1 1 1 1 1 1 1 1 
1 2 2 0 8 14 0 0 0 0 0 0 0 0 3 0 0 0 0 0 13 9 2 2 1 
1 2 0 0 8 0 0 0 0 5 0 0 5 0 3 0 5 0 0 0 0 0 0 2 1 
1 0 0 0 8 0 0 0 0 0 0 0 0 0 3 0 0 0 0 0 0 0 0 0 1 
1 0 0 0 8 0 0 0 0 0 0 0 0 0 3 0 0 0 0 2 2 0 0 0 1 
1 0 7 2 1 1 1 1 1 1 1 1 1 1 1 1 1 1 1 1 8 8 8 8 1 
1 0 0 2 1 2 2 0 0 8 0 0 0 6 0 0 0 0 0 1 2 0 0 0 1 
1 0 0 2 1 2 0 0 0 8 0 0 0 0 0 0 0 0 0 1 4 0 0 0 1 
1 0 0 0 1 0 0 0 0 8 0 0 0 0 0 0 0 0 0 1 4 0 0 0 1 
1 0 0 0 1 0 0 0 1 1 1 1 1 1 1 1 8 8 8 1 0 0 0 0 1 
1 0 0 0 1 0 0 0 1 2 2 0 8 0 0 1 0 0 0 1 0 0 0 0 1 
1 0 0 0 1 0 0 0 1 2 0 0 8 0 0 1 0 0 0 1 0 0 0 11 1 
1 0 0 0 1 0 0 0 1 0 5 0 8 0 0 1 0 0 0 1 0 0 0 0 1 
1 6 0 0 1 0 7 0 1 0 0 0 8 0 0 1 0 0 0 1 0 0 0 15 1 
1 0 0 0 1 0 0 0 1 8 8 8 1 1 1 1 0 0 0 1 0 0 0 0 1 
1 0 0 0 1 0 0 0 1 0 0 0 0 0 0 8 0 5 0 1 3 3 3 3 1 
1 0 0 0 1 0 0 0 1 0 0 0 0 0 0 8 0 0 0 1 0 0 0 0 1 
1 8 8 8 1 0 0 0 1 0 5 0 0 0 0 8 0 0 0 1 0 0 0 0 1 
1 3 3 3 1 0 0 0 1 0 0 0 0 0 0 8 0 0 0 1 0 0 0 0 1 
1 9 0 0 1 8 8 8 1 1 1 1 1 1 1 1 1 1 1 1 0 0 0 0 1 
1 13 0 0 1 0 0 0 0 0 0 0 0 0 0 0 0 0 0 8 0 0 7 0 1 
1 0 0 0 1 0 0 0 0 0 0 0 0 0 7 0 0 0 0 8 0 0 0 0 1 
1 2 0 0 1 0 0 0 0 0 0 0 0 0 0 0 0 0 0 8 0 0 0 0 1 
1 2 0 0 1 0 0 0 0 0 0 0 0 0 0 0 0 0 0 8 0 0 0 14 1 
1 2 0 0 1 1 1 1 1 1 1 1 1 1 1 1 1 1 1 1 1 1 1 1 1 
